6
#####
#  ##
#. * #
#$@ ##
#    #
######