6
#####
#  ##
#.$* #
# @ ##
#    #
######