14
########
#+#    #
# #  $ ####
# #   #    #   
# # ###    ###
# # # #   #  #
# # # # # #, #
# # # # #    #
# # #  ##   ## 
# # #   ####  
#   #    #
#    ####
#    #
######