7
###########
# .   $  .#
#       ###
#* #@ #   #
#  $      #
#       ###
#########