8
  ######
  #    #
  # ##@##
### #   #
#  .# $ #
#       #
#  ######
####