6
#####
#  ##
#. * #
# $ ##
# @  #
######