9
####
#. ##
# @ #
#. $#
##$ ###
 #    #
 #    #
 #  ###
 ####