7
     ###
######@##
#    .* #
#   #   #
#####$# #
    #   #
    #####